10
tourism=information
29
278486913
1191478920
1166052493
1161020685
1194804882
1159958291
1187139221
1158156447
1187134883
1187130534
1158156458
1113220397
1187130545
263571638
1191453622
1321544502
1187087936
1173440074
1178253259
875810905
1173452763
1188232546
1187131627
1173439981
1187136621
1321544429
130212980
1173452790
1321544187
tourism=attraction
29
1173425152
1161008015
1194804881
1185825688
1321544232
1173487019
1173452924
1174117042
1183684147
1187087922
1187139252
1321544246
278487479
1166036794
1185825984
1321544138
1173487052
1186482388
1178253270
1174124505
1149039199
1183684195
1155459304
1187131625
1183630324
1166052470
1189052408
1191478779
1173439996
tourism=viewpoint
29
1183630338
1160107524
1321544198
1187139206
1185825678
1173486998
1193302811
263571489
1173487010
1174117156
1194769831
1321544109
1173487022
1113220397
1189510578
1173452861
1308680645
1321544135
1188232526
1155459155
1178253270
1173486689
1316588131
1187086180
1321544039
1183721324
1321544557
1158156524
1183641846
tourism=picnic_site
29
1192542594
1183684103
1187119112
1192542602
1188391439
1191507728
1194760979
1187139223
1186511130
1187121698
1191393830
1159071655
1187139242
1191507762
1187130547
1187136562
1174116916
1183630403
1149027140
1321544136
1174116684
1160057037
1179847757
1161008082
1321544412
1191453538
1155459309
1173486959
269567738
tourism=camp_site
29
278486912
449815940
1174124550
1186458763
1187121677
1185825682
1173424923
1193130399
1158156580
1174116648
278970283
1173452972
1158164526
1321544624
1321544372
1193130423
445099447
1159931324
1193130429
1173452989
1173444041
1191393737
1198751054
1188232526
1188391382
1158156506
1174116712
1174116585
1321544043